1111111
10E0011
1000011
10C0C01
1000001
1000P01
1111111